R 1 1

NO ./img/redbrick.xpm

EA ./img/brick.xpm

SO./img/brick.xpm

WE./img/redbrick.xpm

S ./img/puppy.xpm

F 220,220,200

C 0,255,255


        1
       111
      11011
      11011
      11011
      11011
      11011
      11011
      11011
      11011
      11011
     11000111
    110020011
    1000000011         
    1100N0011
     1100011
      11011
       111
        1