R 1960 1080

NO  ./img/redbrick.xpm

EA  ./img/brick.xpm

SO ./img/brick.xpm

WE ./img/redbrick.xpm

S  ./img/puppy.xpm

A ./img/corgi_1.xpm ./img/corgi_2.xpm ./img/corgi_3.xpm

FO ./img/colorstone.xpm

CE ./img/wood.xpm


   11111111111111111111111111
  110000001100000000000000001
11110000011100000000000010001
10010000000000000000000010001
1011000001110000000000001000111111111
1000000000110000011101111000000000001
1111011111111101110000001000111102001
11110111111110111010100100001  100001
11000000110101011100000010001  100001
1000000000000000110000001000111100001
1000000000000000110101001000000000301
11000000110101011111011110N0000000301
1111011111110101111101111000000033301
1111111111111111111111111111111111111