R 1920 1080

NO ./img/redbrick.xpm

EA ./img/brick.xpm

SO ./img/wood.xpm

WE ./img/colorstone.xpm

S ./img/bigb.xp

F 220,0,200

C 0,255,254


111111111111111111111111111111
100000000000000200000000000001
100000000000000000000000000001
100000000000000000000000000001
100000000000000000000000000001
100000000000000000000000000001
100000000000000000000000000001
100000000000000N00000000000001
111111111111111111111111111111
